1111111111111111111111111111111111111111
10E001000000P00000100C000010000000000011
1000010C00000000001000C00010C00100000001
1000010C0000000000000C00010C100100000001
10000000000000000000010000100001000000C1
1000000000000000000001000010000100000011
1000000000000000000001000000000000000001
1000000000000000000001000000000000000001
1000000000000000000000000000001000000001
1000000C00000000000001000000001000000001
1111111111111111111111111111111111111111