1111111111111111111111111111111111111111
100001000000000000100C000010000000000011
1000010C00000000001000C00010C00100000001
1000010C00000P00000000C00010C00100000001
100000000000000000000C0000100001000000C1
100000000000000000000C000010000100000011
100000000000000000000C000000000000000001
100000000000000000000C000000000000000001
1000000000000000000001000000001000000001
1E00000000000000000001000000001000000001
100C011110000000000001000000001000000001
1100011110000000000001000000001000000001
100C011110000000000001000000001000000001
100000C000000000000000000000001000000001
10000011100000000000000000000000000C0001
1000001110000000000000000000001000010001
10000C1110000000000000000000000000000001
10000C0000000000000001000000C00000111111
1000011000000000000001000000100000100011
1111111111111111111111111111111111111111