111111111111111111111111111111111111111
100001000000000000100000001000010000001
101C1C00C100000000100000001000010000001
1P1C0011E10C110000100000001000010000001
10000C00C100110000100000001000010000001
10000C00C100110000100000001000010000001
10000C00C100110000100000001000010000001
10000C00C100110000100000001000010000001
10000C00C100110000100000001000010000001
10000C00C100110000100000001000010000001
10000C00C100110000100000001000010000001
10000C00C100110000100000001000010000001
10000C00C100110000100000001000010000001
10000C00C100110000100000001000010000001
10000C00C100110000100000001000010000001
10000C00C100110000100000001000010000001
10000C00C100110000100000001000010000001
10000C00C100110000100000001000010000001
10000C00C100110000100000001000010000001
10000C00C100110000100000001000010000001
111111111111111111111111111111111111111