1111111111111
1000010000001
101C1C00C1001
1P1C0011E10C1
1111111111111
1111111111111