11111111111111111111
1P010000000C100100E1
10000Q11110000010001
1000110000010Q000001
1C001100000100100001
1000QC0000C10010Q001
1Q0011Q000010010QC01
10001C0000100000Q001
100QC01000C000100001
11111111111111111111