11111111111111
1P01000Q000QC1
10000Q11011111
1000Q000000QE1
1C001100000011
1000QC0000C001
11111111111111