NO ./src/assets/colors/green.xpm
SO ./src/assets/colors/red.xpm
WE ./src/assets/colors/yellow_1.xpm
EA ./src/assets/colors/blue.xpm

C 255,255,255
F 243,107,21

111111111111111111111111111111111111111111111111111111111111111111111111111111111111111111111111111111111111111111111111111111
100000000010000000001100000000000000000000000000000000000000001100000000010000000001100000000000000000000000000000000000000001
100000000010000000001100000000000000000000000000000000000000001100000000010000000001100000000000000000000000000000000000000001
100000000010000000000000000000000000000000000000000000000000001100000000010000000001100000000000000000000000000000000000000001
100000000010000000000000000000000000000000000000000000000000001100000000010000000001100000000000000000000000000000000000000001
100000000010000000000000000000000000000000000000000000000000001100000000010000000001100000000000000000000000000000000000000001
100000000010000000000000000000000000000000000000000000000000001100000000010000000001100000000000000000000000000000000000000001
100000000010000000000000000000000000000000000000000000000000001100000000010000000001100000000000000000000000000000000000000001
100000000010000000000000000000000000000000000000000000000000001100000000010000000001100000000000000000000000000000000000000001
100000000010000000000000000000000000000000000000000000000000001100000000010000000001100000000000000000000000000000000000000001
100000000000000000000000000000000000000000000000000000000000001100000000010000000001100000000000000000000000000000000000000001
100000000000000000000000000000000000000000000000000000000000001100000000000000000000000000000000000000000000000000000000000001
100000000000000000000000000000000000000000000000000000000000001100000000000000000000000000000000000000000000000000000000000001
100000000000000000000000000000000000000000000000000000000000000000000000000000000000000000000000000000000000000000000000000001
100000000000000000000000000000000000000000000000000000000000000000000000000000000000000000000000000000000000000000000000000001
100000000000000000000000000000000000000000000000000000000000000000000000000000000000000000000000000000000000000000000000000001
100000000000000000000000000000000000000000000000000000000000000000000000000000000000000000000000000000000000000000000000000001
100000000000000000000000000000000000000000000000000000000000000000000000000000000000000000000000000000000000000000000000000001
100000000000000000000000000000000000000000000000000000000000000000000000000000000000000000000000000000000000000000000000000001
100000000000000000000000000000000000000000000000000000000000000000000000000000000000000000000000000000000000000000000000000001
100000000000000000000000000000000000000000000000000000000000000000000000000000000000000000000000000000000000000000000000000001
100000000000000000000000000000000000000000000000000000000000000000000000000000000000000000000000000000000000000000000000000001
100000000000000000000000000000000000000000000000000000000000000000000000000000000000000000000000000000000000000000000000000001
100000000000000000000000000000000000000000000000000000000000000000000000000000000000000000000000000000000000000000000000000001
100000000000000000000000000000000000000000000000000000000000000000000000000000000000000000000000000000000000000000000000000001
100000000000000000000000000000000000000000000000000000000000000000000000000000000000000000000000000000000000000000000000000001
100000000000000000000000000000000000000000000000000000000000000000000000000000000000000000000000000000000000000000000000000001
100000000000000000000000000000000000000000000000000000000000000000000000000000000000000000000000000000000000000000000000000001
100000000000000000000000000000000000000000000000000000000000000000000000000000000000000000000000000000000000000000000000000001
100000000000000000000000000000000000000000000000000000000000000000000000000000000000000000000000000000000000000000000000000001
100000000000000000000000000000000000000000000000000000000000000000000000000000000000000000000000000000000000000000000000000001
100000000000000000000000000000000000000000000000000000000000000000000000000000000000000000000000000000000000000000000000000001
100000000000000000000000000000000000000000000000000000000000000000000000000000000000000000000000000000000000000000000000000001
100000000000000000000000000000000000000000000000000000000000000000000000000000000000000000000000000000000000000000000000000001
100000000000000000000000000000000000000000000000000000000000000000000000000000000000000000000000000000000000000000000000000001
100000000000000000000000000000000000000000000000000000000000000000000000000000000000000000000000000000000000000000000000000001
100000000000000000000000000000000000000000000000000000000000000000000000000000000000000000000000000000000000000000000000000001
100000000000000000000000000000000000000000000000000000000000000000000000000000000000000000000000000000000000000000000000000001
100000000000000000000000000000000000000000000000000000000000000000000000000000000000000000000000000000000000000000000000000001
100000000000000000000000000000000000000000000000000000000000000000000000000000000000000000000000000000000000000000000000000001
100000000000000000000000000000000000000000000000000000000000000000000000000000000000000000000000000000000000000000000000000001
100000000000000000000000000000000000000000000000000000000000000000000000000000000000000000000000000000000000000000000000000001
100000000000000000000000000000000000000000000000000000000000000000000000000000000000000000000000000000000000000000000000000001
100000000000000000001100000000000000000000000000000000000000000000000000000000000000000000000000000000000000000000000000000001
100000000000000000001100000000000000000000000000000000000000001100000000000000000000000000000000000000000000000000000000000001
100000000000000000001100000000000000000000000000000000000000001100000000000000000000000000000000000000000000000000000000000001
100000000000000000001100000000000000000000000000000000000000001100000000000000000000000000000000000000000000000000000000000001
100000000000000000000000000000000000000000000000000000000000000000000000000000000000000000000000000000000000000000000000000001
100000000010000000001100000000000000000000000000000000000000001100000000010000000001100000000000000000000000000000000000000001
100000000010000000001100000000000000000000000000000000000000001100000000010000000001100000000000000000000000000000000000000001
100000000010000000001100000000000000000000000000000000000000001100000000010000000001100000000000000000000000000000000000000001
100000000010000000001100000000000000000000000000000000000000001100000000010000000001100000000000000000000000000000000000000001
100000000010000000001100000000000000000000000000000000000000001100000000010000000001100000000000000000000000000000000000000001
100000000010000000001100000000000000000000000000000000000000001100000000010000000001100000000000000000000000000000000000000001
100000000010000000001100000000000000000000000000000000000000001100000000010000000001100000000000000000000000000000000000000001
100000000010000000001100000000000000000000000000000000000000001100000000010000000001100000000000000000000000000000000000000001
10000000001000000000110000000000000000000000000N000000000000001100000000010000000001100000000000000000000000000000000000000001
111111111111111111111111111111111111111111111111111111111111111111111111111111111111111111111111111111111111111111111111111111