NO ./src/assets/anime/no.xpm
SO ./src/assets/anime/so.xpm
WE ./src/assets/anime/we.xpm
EA ./src/assets/anime/ea.xpm

F 255,216,0
C 0,87,184

111111111111111111111111111111111111111111111111
100000000010000000001100000000000000000000000001111111111111111
100000000000000000000000000000000000000000000000000000000000001
100000000010010000000000000000000000000000000000000000000000001
111111111011000001110000000000001111111111111110001111111111111
100000000000000001110111110111111             11001     
11110111111111011100000010001                 100011 
1111011111111101110101000000111111             11001  
1100000011010101110000000000000001             11001  
1000000000000000000000001000111111             110011 
10000000000000001101010010001                   10001  
11000001111111111111001010001111111             10001  
11110111          10100001000000001             11001  
11100111          11100111011111101             11001  
10000001111111111110000001001   101             11001 
1100000111010100000110111100111110111111111111111000111111
1000000000000000110101001000100000000000000000000000000001
1000000000000000110001001000000000000000000001100000000001
1000000S00000000000000000000110000000000000001100000010001
1000000000000000110101001000111111111111111111111111111111
11110111001010101000000010001
11110111001111101111011000011
11000001110101011111011110011
11110111 1110101 100000000001
11111111 1111111 111111111111