NO ./src/assets/anime/no.xpm
SO ./src/assets/anime/so.xpm
WE ./src/assets/anime/we.xpm
EA ./src/assets/anime/ea.xpm

F 255,216,0
C 0,87,184

111111
100001
1000011
100N001
1111111