NO ./src/assets/anime/no.xpm
SO ./src/assets/anime/so.xpm
WE ./src/assets/anime/we.xpm
EA ./src/assets/anime/ea.xpm

F 0,87,184
C 255,216,0

11111
10001
10W01
10001
11111