NO ./src/assets/anime/no.xpm
SO ./src/assets/anime/so.xpm
WE ./src/assets/anime/we.xpm
EA ./src/assets/anime/ea.xpm

F 255,216,0
C 0,87,184

111111111111111111111111111111111111111111111111111111111111111111111111111111111111111111111111111111111111111111111111111111
100000000010000000001100000000000000000000000000000000000000001100000000010000000001100000000000000000000000000000000000000001
100000000010000000001100000000000000000000000000000000000000001100000000010000000001100000000000000000000000000000000000000001
100000000010000000000000000000000000000000000000000000000000001100000000010000000001100000000000000000000000000000000000000001
100000000010000000000000000000000000000000000000000000000000001100000000010000000001100000000000000000000000000000000000000001
100000000010000000000000000000000000000000000000000000000000001100000000010000000001100000000000000000000000000000000000000001
100000000010000000000000000000000000000000000000000000000000001100000000010000000001100000000000000000000000000000000000000001
100000000010000000000000000000000000000000000000000000000000001100000000010000000001100000000000000000000000000000000000000001
100000000010000000000000000000000000000000000000000000000000001100000000010000000001100000000000000000000000000000000000000001
100000000010000000000000000000000000000000000000000000000000001100000000010000000001100000000000000000000000000000000000000001
100000000010000000000000000000000000000000000000000000000000001100000000010000000001100000000000000000000000000000000000000001
100000000010000000000000000000000000000000000000000000000000001100000000010000000001100000000000000000000000000000000000000001
100000000010000000000000000000000000000000000000000000000000001100000000010000000001100000000000000000000000000000000000000001
100000000010000000000000000000000000000000000000000000000000000000000000010000000001100000000000000000000000000000000000000001
100000000010000000000000000000000000000000000000000000000000000000000000010000000001100000000000000000000000000000000000000001
100000000010000000001100000000000000000000000000000000000000000000000000010000000001100000000000000000000000000000000000000001
100000000010000000001100000000000000000000000000000000000000000000000000010000000001100000000000000000000000000000000000000001
100000000010000000001100000000000000000000000000000000000000000000000000010000000001100000000000000000000000000000000000000001
100000000010000000001100000000000000000000000000000000000000000000000000010000000001100000000000000000000000000000000000000001
100000000010000000001100000000000000000000000000000000000000000000000000010000000001100000000000000000000000000000000000000001
100000000010000000001100000000000000000000000000000000000000001100000000010000000001100000000000000000000000000000000000000001
100000000010000000001100000000000000000000000000000000000000001100000000010000000001100000000000000000000000000000000000000001
100000000010000000001100000000000000000S00000000000000000000001100000000010000000001100000000000000000000000000000000000000001
100000000000000000000000000000000000000000000000000000000000000000000000000000000000000000000000000000000000000000000000000001
100000000010000000001100000000000000000000000000000000000000001100000000010000000001100000000000000000000000000000000000000001
100000000010000000001100000000000000000000000000000000000000001100000000010000000001100000000000000000000000000000000000000001
100000000010000000001100000000000000000000000000000000000000001100000000010000000001100000000000000000000000000000000000000001
100000000010000000001100000000000000000000000000000000000000001100000000010000000001100000000000000000000000000000000000000001
100000000010000000001100000000000000000000000000000000000000001100000000010000000001100000000000000000000000000000000000000001
100000000010000000001100000000000000000000000000000000000000001100000000010000000001100000000000000000000000000000000000000001
100000000010000000001100000000000000000000000000000000000000001100000000010000000001100000000000000000000000000000000000000001
100000000010000000001100000000000000000000000000000000000000001100000000010000000001100000000000000000000000000000000000000001
100000000010000000001100000000000000000000000000000000000000001100000000010000000001100000000000000000000000000000000000000001
111111111111111111111111111111111111111111111111111111111111111111111111111111111111111111111111111111111111111111111111111111