NO ./src/assets/anime/no.xpm
SO ./src/assets/anime/so.xpm
WE ./src/assets/anime/we.xpm
EA ./src/assets/anime/ea.xpm

F 255,216,0
C 0,87,184

111111111111111
1000011110000011111
10E0000000000000001
1000000001111111111
1111111111